32  32
BBBOBOOOBOOOBBBBBBBBOOOBOOOBBBBB
BBTOOYYYOYYYOBTBBTBOYYYOYYYOBTBB
BBBOYOBOYOBOYOBBBBOYOBOYOBOYOBBB
BBOOOBBBBBBBOYOBBOYOBBBBBBBOYOBB
BBOOBBBBBBBBBYOBBOYBBBBBBBBBYOBB
BBPOOOOOOOOOOOOOOOOOOOOOOOOOOOBB
BBOOBBBXXXBBBYOBBOYBBBXXXBBBYOBB
BBOOYOBBBBBOYOBBBBOYOBBBBBOYOBBB
BBOOOYBBBBBOYOBBBBBOYBBBBBOYOBBB
BBOOBOYOBOYOBBBBBBBBOYOBOYOBBBBB
BBOPBBOYYYOBBOBBBBOBBOYYYOBBOBBB
BBOOBBBOOOBBBOTBBTOBBBOOOBBBOTBB
BBOOOBBBBBBBBBOOBBOOBBBBBBBBBOOB
BBOOBOOOBOOOBOBBBBBBOOOBOOOBBBBB
BBOOOOOOOOOOOOOOPOOOOOOOOOOOOOBB
BBOOOOOOOOOOOOOOOOOOOOOOOOOOOOBB
BBOOOOOOOOOOOOOOOOOOOOOOOOOOOOBB
BBOOOOOOOOOOOOOOPOOOOOOOOOOOOOBB
BBOYOBBBBBBBOYOBBOYOBBBBBBBOYOBB
BBOYBBBXXXBBBYOBBOYBBBXXXBBBYOBB
BBOOYOBBBBBOYOBBBBOYOBBBBBOYOBBB
BBOBOYBBBBBOYOBBBBBOYBBBBBOYOBBB
BBOBBOYOBOYOBBBBBBBBOYOBOYOBBBBB
BBOOBBOYYYOBBOBBBBOBBOYYYOBBOBBB
BBOOBBBOOOBBBOTBBTOBBBOOOBBBOTBB
BBOOBBBBBBBBBOOBBOOBBBBBBBBBOOBB
BBOOBBOYYYOBBOBBBBOBBOYYYOBBOBBB
BBOOBBBOOOBBBOTBBTOBBBOOOBBBOTBB
BBOOBBBBBBBBBOOBBOOBBBBBBBBBOOBB
BBOOBBOYYYOBBOBBBBOBBOYYYOBBOBBB
BBOOBBBOOOBBBOTBBTOBBBOOOBBBOTBB
BBBBBBBBBBBBBOOBBOOBBBBBBBBBOOBB