32  32
BBBOOOOOOOOBBBBBBBOOOOOOOOBBBBBB
XXYOXXXXXXOXXXXXXYOXXXXXXOXXXXBB
XXYYXXXXXXYXXXXXXYYXXXXXXYXXXXBB
BBBBBBBBBBOOOBBBBBBBBBBBBOOOBBBB
XXXXXOXXXXXOYXXXXXXXOXXXXXOYXXBB
XXOOOOOOOOOOOOOOOOOOOOOOXXOYXXBB
BBOOOOBBBOOOBBBBBOOOOBBOOOOBBBBB
XXYOXXXXXYXOXXXXXYOXXXXOYXXXXXBB
XXYOXXXXXOXOXXXXXYOXXXXOOXXXXXBB
BBOOOBBBBBBOBBBBBOOOBBBOBBBBBBBB
XXXXYXXXXXXOYXXXXXXYXXXOXXYYXXBB
XXXXOXXXXXXOYXXXXXXOXXXOXXOYXXBB
BBBBOOOOPOOOOBBBBBBBOOOOOOOOBBBB
BBBOOOOOOOOOBBBBBBOOOOPOOOBBBBBB
XXYOXXXXXXOOXXXXXYOXXXXXXOXXXXBB
XXYYXXXXXXOOOOOPBYYXXXXXXYXXXXBB
BBBBOOOOPOOOOBBBBBBBBBBOBOOOBBBB
XXOOOOOOOOOOOOOOOOOOOOOOOXOYXXBB
XXXXXYXXXXXOYXXXXXXXYXXOXXOYXXBB
BBOOOOBBBOOOBBBBBOOOOBBoOOOBBBBB
XXYOXXXXXYXXXXXXXYOXXXXXYXXXXXBB
XXYOXXXXXOXXXXXXXYOXXXXXOXXXXXBB
BBOOOBBBBBBBBBBBBOOOBBBBBBBBBBBB
XXXXYXXXXXXYYXXXXXXYXXXXXXYYXXBB
XXXXOXXXXXXOYXXXXXXOXXXXXXOYXXBB
BBBBOOOOOOOOBBBBBBBOOOOOOOOBBBBB
BBBOOOOOOOOBBBBBBBOOOOOOOOBBBBBB
XXYOXXXXXXOXXXXXXYOXXXXXXOXXXXBB
XXYYXXXXXXYXXXXXXYYXXXXXXYXXXXBB
BBBBBBBBBBOOOBBBBBBBBBBBBOOOBBBB
XXYYXXXXXXYXXXXXXYYXXXXXXYXXXXBB
BBBBBBBBBBOOOBBBBBBBBBBBBOOOBBBB