13 15
PBBBBIOOYIXBXPX
OXBXBTYOOTBBOOO
OOBBBIOYYIXYXYX
YXYXYTYOOTBBBBB
BBBBBIOOYIXYXYX
BXBXBTYYOOBBBBB
TITITIOOYITITIT
BBBBBOYOOTBXBXB
XBXBXIOYYIBBBBB
BBBBBTYOOTBXBXB
XOXYXIOOYIBBBBO
OOBBBTYYOTYXYXO
XPXBXIOOYIBBBOP